3 0 0 0 3 3 3 3 3 3 3 3 3 3 3 3
3 0 0 0 0 0 0 0 0 0 6 0 6 0 0 3
3 0 0 0 0 0 0 6 0 0 0 0 0 0 6 3
3 0 0 0 0 0 0 0 0 0 0 0 0 0 0 3
3 0 0 0 0 0 0 0 6 0 0 0 0 5 5 3
3 0 0 6 0 0 0 0 0 0 0 0 5 5 4 3
3 0 0 0 0 0 0 0 0 0 0 5 5 4 4 3
3 6 0 6 0 0 6 0 6 0 0 5 4 4 4 3
3 3 3 3 3 3 3 3 3 3 3 3 3 3 3 3